


    ****/\******
    ****/\******
    ************
    *!*******+**
    ************
    **-*********  *************
    *$**********  ****~**~**~**
    ************  *************
    ************  ***$******~**
    *****+******  *-*******+***
    ************  *************
         ***           ***
         ***           ***
         ***           ***
  ********************************
  ****************************-***
  ********************************
  ********************************
  ********************************
  ***********+********************
  ********************************
  ********************************
  ********************************
  ********************************
        ***
        ***
        ***
        ***
 *******************
 *&***************** 
 *******************    ********
 *******+****-******    *!!*****
 **$****************    ********
 ****************************-**
 **************************$****
 *******************************
 *******************    +*******
 *******************    ********
 *******************    