************************
************************
************************
************************
******************~~~***
******************lj~***
******************%@~***
******************~~~***
***********<************
************************
***~~~******************
***~k7******************
***~^&******************
***~~~******************
************************
************************
************************
