*****
*$***  ************************
*********!!!*******************
*********lj!*******************
*********%@!*******************
*********!!!*******************
*$***  ******************~~~***
*****  ******************lj~***
       ******************%@~***
       ******************~~~***
       ***********<************
       ************************
       ***~~~******************
       ***~k7******************
       ***~^&******************
       ***~~~******************
       ************************
       ************************
       ************************
