*+-+-+-+-+-+-+
+*+-+-+-+-+-+-
-+*+-+-+-+-+-+
+-+*+-+-+-+-+-
-+-+*+-+-+-+-+
+-+-+*+-+-+-+-
-+-+-+*+-+-+-+
+-+-+-+*+-+-+-
-+-+-+-+*+-+-+
+-+-+-+-+*+-+-
-+-+-+-+-+*+-+
+-+-+-+-+-+*+-
-+-+-+-+-+-+*+
+-+-+-+-+-+-+*