7866666666666666666666667
]***********/\**********[
[***********/\**********[
[***********************[
[***********************[
[***********************[
[***********************[
[***********************[
[***********************[
[***********************[
[***********************[
[***********************[
[***********<***********[
[***********************[
4***********************[
7866666666666666666666697
