     *****
     *****
     *****
     *****
     *****
     *****
     *****
     *****
     *****
     *****
     *****
***************
***************
***************
***************
***************
***************
***************
*******<*******
***************
***************
***************
***************
***************
