      **/\**
      **/\**
      ******
      ******
      ******
      ******
      ******
      ******
      ******
      ******
      ******
******************
******************
******************
******************
******************
******************
******************
*********<********
******************
******************
******************
******************
******************
