             *****/\*****
             *****/\*****
             ************
             ************
             ************
             *****!!*****
             ************
             ************
             ************
             ************
             ************
             ************
                ******
                ******
                ******
                ******
                ******
                ******
                ******
*********       ******
*****$*n*   *********************
*******m*   *>*******************
******$**   **>******************
*********   *********************
*****                       *****
*****                       *****
*****                       *****
*****        **>**          *****
*>***        *$*$*          *****
****&        *****          *****
*****        *****          *****
*****        *****          *****
*****        *****          *****
*****        ****&      *****************************************
*****        *****      *****************************************
*****        *****      k)***************************************
*****        *****      ^(***************************************
*****        *****      *******&*****&*****&*****&******&********
*****        &****                                          *****
*****        *****                                          *****
*****        *****                                          *****
*****        *****                                          *****
*****        *****                                          *****
*****        *****                                          *****
***************************&**************`**********       *****
*&****************************************>**********       *****
*****************************************************       *****
*****************************************************       **$**
*****************************************************       *****
*****                                   ****                *****
*****                                   ****                *****
*****                                   ****                *****
*****                 *****             ****                *****
******************    *$n$*             &***                *****
****************&*    **m**             ****     *&**************
******************    *****             ****     ****************
******************    *****             ****     ****************
             *****    *****             ****     ****************
             *****    *****             ****     ****
             *****    ***************   ****     ****
             *****    k)*************   ****     ****
             *****    ^(*************   ****     ****
******************               ****   ****     ****
**>***************               ****   ****     ****&*****
******************               ****   ****     **********
******************               ****   ***&     **********
*****        *****               ****   ****     *&********
*****        ************>***********   ****           ****
*****        **&*********************   ****           ****
*****        ************************   ****           ****
*****        ************************   ****           ****
*****                                   ****           ****
*****                                   ****           ****
*****                                   ****           ****
*****                                   ****           ****
***&*******************************************************
*********************************************************lj
******************>**************************************%@
&**********************************************************
                       ******
                       ******
                       ******
                       ******
                       ******
                       ******
                       ******
                       ******
                       ******
                       ******
                       ******
                       ******
                 ******************
                 ******************
                 ******************
                 ******************
                 ******************
                 ******************
                 ******************
                 *********<********
                 ******************
                 ******************
                 ******************
                 ******************
                 ******************
