7666666666666666666666667
[***********/\**********[
[***********/\**********[
[***********************[
[***********************[
[***********************[
[***********************[
[***********************[
[***********************[
[***********************[
[***********************[
[***********************[
[***********<***********[
[***********************[
[***********************[
7866666666666666666666697
