


    ****/\******
    ****/\******
    ************
    *!*******+**
    ************
    **-*********  *************
    ************  ****~**~**~**
    ************  *************
    ************  **********~**
    *****+******  *-*******+***
    ************  *************
         **            **
         **            **
         **            **
  ********************************
  ****************************-***
  ********************************
  ********************************
  ********************************
  ***********+********************
  ********************************
  ********************************
  ********************************
  ********************************
        ***
        ***
        ***
        ***
 *******************
 *&***************** 
 *******************    ********
 *******+****-******    *!!*****
 *******************    ********
 ****************************-**
 *******************************
 *******************    +*******
 *******************    ********
 *******************    